atangel = new Audio('data/SR SFX/atc_Angel.wav'),
atboxer = new Audio('data/SR SFX/atc_Boxer.wav'),
atglad = new Audio('data/SR SFX/atc_Gladiator.wav'),
atgunner = new Audio('data/SR SFX/atc_Gunner.wav'),
atmag = new Audio('data/SR SFX/atc_Magician.wav'),
atpriest = new Audio('data/SR SFX/atc_Priest.wav'),
atsniper = new Audio('data/SR SFX/atc_Sniper.wav'),
atwhipper = new Audio('data/SR SFX/atc_Whipper.wav'),
deathboss1 = new Audio('data/SR SFX/Boss.wav'),
deathboss2 = new Audio('data/SR SFX/Boss2.wav'),
casherror = new Audio('data/SR SFX/casherror.wav'),
cashregister = new Audio('data/SR SFX/cashregister.wav'),
click = new Audio('data/SR SFX/click.wav'),
click2 = new Audio('data/SR SFX/click2.wav'),
click3 = new Audio('data/SR SFX/click3.wav'),
compose = new Audio('data/SR SFX/compose.wav'),
deathplayer = new Audio('data/SR SFX/dead.wav'),
dmgplayer = new Audio('data/SR SFX/dmg_Player.wav'),
fire = new Audio('data/SR SFX/fire.wav'),
freeze = new Audio('data/SR SFX/freeze.wav'),
gong_finish = new Audio('data/SR SFX/gong_finish.wav'),
gong_start = new Audio('data/SR SFX/gong_start.wav'),
hotel = new Audio('data/SR SFX/hotel.wav'),
ice = new Audio('data/SR SFX/ice.wav'),
levelup = new Audio('data/SR SFX/Levelup.wav'),
money = new Audio('data/SR SFX/money.wav'),
onigiri = new Audio('data/SR SFX/onigiri.wav'),
parameter = new Audio('data/SR SFX/parameter.wav'),
physical = new Audio('data/SR SFX/physical.wav'),
poison = new Audio('data/SR SFX/poison.wav'),
rebirth = new Audio('data/SR SFX/rebirth.wav'),
sp = new Audio('data/SR SFX/sp.wav'),
thunder = new Audio('data/SR SFX/thunder.wav'),
weapon = new Audio('data/SR SFX/weapon.wav');